....%%%%%%%%....
...%########%...
..%##########%..
.%############%.
.%###@##@###@%.
.%###########%.
..%#########%..
...%#######%...
....%#####%....
.....%###%.....
......%#%......
